#############
#...........#
#..###......#
#...@#......#
#@.#.@......#
#############
