#########
#..p.B..#
#..###. #
#...@#P.#
#@.#.@..#
#########
