##########
#..p.B..#
#..###. #
#...@#..#
#@.#.@..#
#########
