####@####
#.......#
#..###..#
#...@#..#
#@.#.@..#
#########
